ぁ	xa	la
あ	a
ぃ	xa	li
い	i
ぅ	xu	lu
う	u
うぃ	wi
うぇ	we
ぇ	xe	le
え	e
ぉ	xo	lo
お	o
か	ka
が	ga
き	ki
きぃ	kyi
きぇ	kye
きゃ	kya
きゅ	kyu
きょ	kyo
ぎ	gi
ぎぃ	gyi
ぎぇ	gye
ぎゃ	gya
ぎゅ	gyu
ぎょ	gyo
く	ku
くぁ	qa
くぃ	qi
くぇ	qe
くぉ	qo
ぐ	gu
け	ke
げ	ge
こ	ko
ご	go
さ	sa
ざ	za
し	si
しぃ	syi
しぇ	sye	she
しゃ	sya	sha
しゅ	syu	shu
しょ	syo	sho
じ	zi	ji
じぃ	zyi
じぇ	zye	je
じゃ	zya	ja
じゅ	zyu	ju
じょ	zyo	jo
す	su
ず	zu
せ	se
ぜ	ze
そ	so
ぞ	zo
た	ta
だ	da
ち	ti
ちぃ	tyi	cya
ちぇ	tye	cyu
ちゃ	tya	ca
ちゅ	tyu	cyi
ちょ	tyo	cyo
ぢ	di
ぢぃ	dyi
ぢぇ	dye
ぢゃ	dya
ぢゅ	dyu
ぢょ	dyo
っ	xtu	xtsu	ltu	ltsu
つ	tu	tsu
つぁ	tsa
つぃ	tsi
つぇ	tse
つぉ	tso
づ	du
て	te
てぃ	thi
てぇ	the
てゃ	tha
てゅ	thu
てょ	tho
で	de
でぃ	dhi
でぇ	dhe
でゃ	dha
でゅ	dhu
でょ	dho
と	to
とぁ	twa
とぃ	twi
とぅ	twu
とぇ	twe
とぉ	two
ど	do
な	na
に	ni
にぃ	nyi
にぇ	nye
にゃ	nya
にゅ	nyu
にょ	nyo
ぬ	nu
ね	ne
の	no
は	ha
ば	ba
ぱ	pa
ひ	hi
ひぃ	hyi
ひぇ	hye
ひゃ	hya
ひゅ	hyu
ひょ	hyo
び	bi
びぃ	byi
びぇ	bye
びゃ	bya
びゅ	byu
びょ	byo
ぴ	pi
ぴぃ	pyi
ぴぇ	pye
ぴゃ	pya
ぴゅ	pyu
ぴょ	pyo
ふ	hu	fu
ふぁ	fa
ふぃ	fi
ふぇ	fe
ふぉ	fo
ふゅ	fyu
ぶ	bu
ぷ	pu
へ	he
べ	be
ぺ	pe
ほ	ho
ぼ	bo
ぽ	po
ま	ma
み	mi
みぃ	myi
みぇ	mye
みゃ	mya
みゅ	myu
みょ	myo
む	mu
め	me
も	mo
ゃ	xya	lya
や	ya
ゅ	xyu	lyu
ゆ	yu
ょ	xyo	lyo
よ	yo
ら	ra
り	ri
りぃ	ryi
りぇ	rye
りゃ	rya
りゅ	ryu
りょ	ryo
る	ru
れ	re
ろ	ro
ゎ	xwa	lwa
わ	wa
を	wo
ん	n	nn	xn
